1 2012 125 3,4 50,3 125,2 25,1
2 银河系漫游指南 42 113,4 100,3 64,2 2,1
3 黑客帝国 108 91,4 118,3 108,2 33,1
4 生化危机 111 41,4 79,3 107,2 124,1
5 银河英雄传说 123 92,4 21,3 123,2 81,1
6 星际迷航 120 116,4 119,3 120,2 92,1
7 冰河世纪 107 1,4 9,3 101,2 107,1
8 一九八四 127 99,4 61,3 127,2 112,1
9 娱乐至死 118 117,4 89,3 85,2 118,1
10 废土世界 114 111,4 96,3 114,2 95,1
11 天空之城 116 5,4 66,3 116,2 86,1
12 诺查丹玛斯预言 121 125,4 7,3 23,2 51,1
13 明天之后 126 126,4 25,3 103,2 120,1
14 理想国与哲人王 109 6,4 60,3 43,2 72,1
15 大国崛起 127 19,4 12,3 127,2 94,1
16 末日审判 124 39,4 35,3 26,2 23,1
17 欢乐颂 115 74,4 71,3 52,2 63,1
18 警察与赞美诗 78 128,4 122,3 115,2 96,1
19 亚特兰蒂斯 119 47,4 95,3 8,2 105,1
20 日本沉没 128 83,4 53,3 37,2 30,1